NO ./path_to_the_north_texture

SO ./path_to_the_south_texture

WE ./path_to_the_west_texture

EA ./path_to_the_east_texture

F 220,100,0

C 220,100,0

111111111
100000N01
100000001
100000001
100000001
111111111
