NO./map/texture/north.xpm

SO ./map/texture/south.xpm

WE ./map/texture/west.xpm

EA ./map/texture/east.xpm

F 220,100,0

C 220,100,0

111111111111111111111
100000000000000000111
11N000000000000000011
100000100000000000001
100000000000000000001
100000000000000000001
100000000000000000001
100000000000000000001
111111111111111111111
