NO./map/texture/north.xpm

SO ./map/texture/south.xpm

WE ./map/texture/west.xpm

EA ./map/texture/east.xpm

F 220,100,0

C 220,100,0

11111111111
10000000001
10000N00001
10000001001
10000000001
11100000001
10000100111
10000000001
10000000001
11110000001
10000000001
10000100001
10000000001
10000000001
10000000001
11111111111
