NO./map/texture/north.xpm

SO ./map/texture/south.xpm

WE ./map/texture/west.xpm

EA ./map/texture/east.xpm

F 17, 103, 0

C 95, 182, 240

111111111111111111111111111111
111111111111111011111111111111
111111111111110001111111111111
111111111111100000111111111111
111111111110000000001111111111
111111111000000000000011111111
111111100000000000000001111111
111111000000000000000000111111
111110000000000000000000011111
111100000000000000000000001111
111000000000000000000000000111
110000000000000000000000000011
100000000000000100000000000001
100000000000000000000000000001
100000000000000000000000000001
100000000000000000000000000001
100000000000000000000000000001
100000000000000N00000000000001
100000000000000000000000000001
100000000000000000000000000001
100000000000000000000000000001
100000000000000000000000000001
100000000000000000000000000001
100000000000000000000000000001
100000000000000000000000000001
100000000000000000000000000001
100000000000000000000000000001
100000000000000000000000000001
100000000000000000000000000001
111111111111111111111111111111
