NO./map/texture/north.xpm

SO ./map/texture/south.xpm

WE ./map/texture/west.xpm

EA ./map/texture/east.xpm

F 222,160,99

C 176, 211, 243

111111111111111111111111111111
111111111111111011111111111111
111111111111110001111111111111
111000000000000000000000000111
1100000000N0000000000000000011
100000000000000100000000000001
100000000000000000000000000001
100000000000000000000000000001
100000000000000000000000000001
100000000000000000000000000001
100000000000000000000000000001
100000000000000000000000000001
100000000000000000000000000001
100000000000000000000000000001
100000000000000000000000000001
100000000000000000000000000001
100000000000000000000000000001
100000000000000000000000000001
100000000000000000000000000001
100000000000000000000000000001
100000000000000000000000000001
100000000000000000000000000001
111111111111111111111111111111
