NO ./map/texture/north.xpm

SO ./map/texture/north.xpm

WE ./map/texture/north.xpm

EA ./map/texture/north.xpm

F 17, 103, 0

C 95, 182, 240

11111111111111111111111111111
1111111111111110111111111111111
1111111111111100011111111111111
1111111111111000001111111111111
1111111111110000000111111111111
1111111111100000000011111111111
1111111111000000000001111111111
1111111110000000000000111111111
1111111100000000000000011111111
1111111000000000000000001111111
1111110000000000000000000111111
1111100000000000000000000011111
1111000000000000000000000001111      
1110000000000000000000000000111
1100000000000000000000000000011
1000000000000001000000000000001
1000000000000000000000000000001
1000000000000000000000000000001
1000000000000000000000000000001
1000000000000000000000000000001
100000000000000N000000000000001
1000000000000000000000000000001
1000000000000000000000000000001
1000000000000000000000000000001
1000000000000000000000000000001
1000000000000000000000000000001
1000000000000000000000000000001
1000000000000000000000000000001
1000000000000000000000000000001
1000000000000000000000000000001
1000000000000000000000000000001
111111111111111111111111111111
